111111111
1dgfdghf1
1dgfdghf1
1dgfdghf1
1dgfdghf1
111111111