1111111111
1P00000111
1110111011
1000111001
10111110C1
10E0001111
1111111111