1111111111111
100100000C1
100001111101
1P0011E000001
1111111111111