1111111111111
100100000C1
111101
1P0011E000001
1111111111111