1111111111
1000P00C01
1001000P01
10P00E0001
1111111111