1111111111111
110010C000C01
1100011111001
1110011E00C01
1110111100001
1100C00000001
1110111000101
100C000000001
1000011000001
11111P0001001
100010C000001
1100111111001
1111111111111